谷歌退出中国	(Goolge|google|谷歌).*退出.*中国
上海11.15大火	上海.*大火|胶州路.*大火|上海.*火灾
钱云会	钱云会
邓玉娇	邓玉娇
李庄	李庄
李刚	李启铭|我爸是李刚
宜黄自焚	钟九如|钟如琴|钟如凤|钟如奎|罗志凤
山西问题疫苗	问题疫苗
重庆打黑事件	重庆.*打黑|文强
江苏盐城自焚	江苏盐城.*自焚
玉树地震	玉树.*地震
舟曲泥石流	舟曲.*泥石流
地沟油	地沟油
北京治堵	北京.*治堵|北京.*堵车
北京车牌摇号	车牌.*摇号|北京.*车牌
奶粉	奶粉.*三聚氰胺|奶粉*性早熟|蒙牛.*中毒
上海眼药门	上海眼药
家乐福价格欺诈	家乐福.*价格欺诈
矿难	矿难
菲律宾人质事件	菲律宾.*人质
智障奴工	智障.*奴工
钱明奇	钱明奇|抚州连环爆炸案
日本地震	日本.*地震|核泄露|福岛|抢盐|盐.*防辐射
个税起征点上调至3500	个税起征点
药家鑫	药家鑫|张妙|张显|药庆卫
富士康员工自杀	富士康.*跳楼
郭美美	郭美美|红十字会
高晓松酒驾	高晓松.*酒驾
乔布斯逝世	乔布斯
校车事故	校车.*事故
温州动车事故	动车.*事故|小伊伊|项炜伊|王勇平
小悦悦事件	小悦悦|陈贤妹
上海地铁10号线	10号线.*追尾
微博打拐及解救乞讨儿童	随手拍照解救乞讨儿童|微博.*打拐
卡扎菲身亡	卡扎菲
本拉登身亡	本拉登
金正日逝世	金正日
航天	神八|神州八号|天宫一号|神九|神州九号
京沪高铁开通	京沪.*高铁
织里抗税	织里.*抗税
南昌大桥百人自杀	南昌大桥.*自杀
成都富士康爆炸	富士康.*爆炸
云南地震	盈江.*地震
驻马店碾人事件	驻马店.*碾死人
乌坎事件	乌坎
故宫系列事件	故宫.*失窃|故宫.*会所|故宫.*封口|故宫.*文物顺坏|哥窑瓷器|故宫.*锦旗
湄公河案	华平号|玉兴8号|湄公河.*案|糯康
会理领导照ps事件	会理.*悬浮
渤海湾油田溢油事故	渤海湾.*溢油
中石油添加茅台	中石油.*茅台
夏俊峰案	夏俊峰
城管打人系列事件	城管
李双江儿子打人	李双江.*李天一
台湾塑化剂	塑化剂
上海染色馒头	染色.*馒头
中国渔船被扣	中国渔船.*扣押
黄海军演	黄海.*军演
航母	航母|辽宁号
赖昌星	赖昌星
限购令-国八条	限购令|国八条|房价.*调控
新婚姻法	新婚姻法
扶老人被诬告	彭宇案|扶老人
双汇瘦肉精	瘦肉精
联防队员打杂民宅强奸女子	杨喜利
方舟子打假	方舟子.*韩寒|方舟子.*李开复|韩寒.*代笔
王立军事件	王立军
薄熙来	薄熙来|薄谷开来
黄岩岛	黄岩岛
钓鱼岛	钓鱼岛
理性爱国，勿伤同胞	反日游行|钓鱼岛.*国有化|平和堂|青岛.*丰田|理性爱国|西安.*打砸抢
各地暴雨	北京.*看海|武汉.*看海|北京.*暴雨
周克华抢劫案	周克华
微博反腐	微博反腐|微笑表叔|杨达才|房叔|房婶|房祖宗|龚爱爱
3B大战	3B|360.*百度|百度.*360
莫言	莫言
十八大	十八大
重庆不雅视频	重庆.*不雅视频|雷政富
切糕	切糕
狼爸教育	萧百佑|狼爸|狼妈
毒胶囊	毒胶囊
老酸奶	老酸奶.*明胶|老酸奶.*皮鞋
活熊取胆	活熊取胆|归真堂
速成鸡	速成鸡|粟海集团
火车票降价	火车票.*降价
购票难	火车票|抢票软件|互联网售票|12306|铁道部
朴槿惠当选韩国总统	朴槿惠
安倍晋三当选日本总统	安倍晋三
白酒行业塑化剂危机	白酒.*塑化剂
国庆长假堵车	国庆.*堵车
高速假期免过路费	高速.*假日.*过路费
国考报考人数井喷	国考.*人数.*井喷
哈尔滨阳明滩大桥坍塌	阳明滩大桥
高考	高考
深圳跑车飙车案	深圳.*飙车
电影1942	电影.*1942|1942.*电影
柴静看见	柴静.*看见
三亚宰客	三亚.*宰客
少年被充气泵塞肛门穿孔	小传旺
公知约架	吴法天|五岳散人|记者周燕|公知.*约架
空气污染	PM2.5|空气.*污染
石油调价	石油.*调价|调价.*石油
抵制排污项目	PX项目
申纪兰	申纪兰
吴英案	吴英
计划生育	计划生育
养老金	养老金.*缺口
伦敦奥运会	伦敦奥运会
微公益	微公益
微博政务	微博政务
文革	文革|文化大革命|文化革命
乌有之乡	乌有之乡
